00000001000000000000000000000000000000044000000000000000000011110000000000000000000000000000000000000000000000000000000000000000000000000000000000000000000
00000001000000000000000000000000000000000000000000000000000011110000000000000000000000400400000000000000000000000000000000000000000000000000000000000000000
00000001000000000000000000000000000000000000000000000000000011110000000000000000000000000000040000000000000000000000000000000000000000000000000000000000000
00000001002111111100000000000000000000000011111111111111100011110000000000000000000000000000000000020000000000000000000000000000000000000000000000000000000
00000001000100000100000000000000000000000017007007007007100011110000000000000000040000000000000000000100000000000000000000000000000000000000000000000000000
00000001002100000100000000000000000000000010000000000000100011110000000000000000000000000000000002000100000000000000000000000000000000000000000000000000000
00000001000100000100000000000000000000000000000000000000000011110000000000000000000000000000000000000100000000000000000000000000000000000000000000000000000
00000001112100000100000000111110000000000000000000000000000011110000000000000000000000000000000200000110000000700000000000000000000000000000000000000000000
00000300010100000100000000888811000000000111111111111111100011110000000000000000000000000000000000000010000000000000000000000000000000000000000000000000000
00021111012100000100000000888881100000000100000000000000100010000000000000200200000000000000000002000010000000000000000000000000000000000000000000000000000
00000000000100000100000000888888100001111100000000000000100010000000000000000000000000000000200000000010000000000000000000010000000000000000000000000000000
P0020000002100000100000000888888006011111000000000000000100010000000000000000000000000000000000200000010000000000000000000010000000000000000000000000000000
00000000000100000100021111111111111111000000000000000000100010000000000000002002000002002000000000000010000000000000000000011000000000000000000000000000000
11110000002100000100001000000000000000000000000000000000100010000000000000000000000000000000000000000010001001000000000000001000000000000000000000000000000
000110000021000001000210000000000000000000000000000000001000100000000000000200000002000000200200000000100110011000060060000F1000000000000000000000000000000
0001120000010000010X001000000000000000000000000000000000100010000000000000000020000000000000000000000011111001111111111111111000000000000000000000000000000
00011000000100000111111000000000000000000000000000000011100010011155555555555550000000002000000000000000000000000000000000000000000000000000000000000000000
0001111111110000000000000000000000000000000000000000001G000030010000000000000000000000000000000000000000000000000000000000000000000000000000000000000000000
00000000000000000000000000000000000000000000000000000011111111110000000000000000000000000000000000000000000000000000000000000000000000000000000000000000000
00000000000000000000000000000000000000000000000000000000000000000000000000000000000000000000000000000000000000000000000000000000000000000000000000000000000
