00000000000000000000000000000000000000000000000000000000000000000000000000000000000000000000000000000000000000000000000000000000000000000000000000000000000
00000000000000000000000000000000000000000000000000000000000000000000000000000000000000000000000000000000000000000000000000000000000000000000000000000000000
11111111111110000000001007000700000000000700000021100000000000000000000000000000000000000000000000000000000000000000000000000000000000000000000000000000000
00000000000010000000000000000000000000000000000001000000000000000000000000000000000000000000000000000000000000000000000000000000000000000000000000000000000
0000000000001000000000S000000000000000000000000101000000000000000000000000000000000000000000000000000000000000000000000000000000000000000000000000000000000
00000000000010000404021111111111111111111111111111000000000000000000000000000000000000000000000000000000000000000000000000000000000000000000000000000000000
P0001111100110000000000000000000000000000000000000000000000000000000000000000005111111110001000000000000000000000000000000000000000000000000000000000000000
00110001100110000000020000000000000000000000000000000000000000000000000000000050008888000201000000000000000000000000000000000000000000000000000000000000000
11000001100110000000000000000000000000000000000000000000000000000000000000000500008888000001000000000000000000000000000000000000000000000000000000000000000
00000001100110000000020000000000000000000000000000000000000000000000000000005000008888111111000000000000000000000000000001110000000000000000000000000000000
00000001000010000000000000000000000000000000000000000000000000000000000000050001111111100000000000000000000000000000000000010000000000000000000000000000000
00000001000010000000200000000000000000000000000000000000000000000000000000500010000000000000000000000000000000000000000000F10000000000000000000000000000000
00000001000010000020000000000000000000000000000100000000000000000000000005000100000000000000000000000000000000000000002111110000000000000000000000000000000
00000001000010002000000000000000000000000000000103000300000000000000020050001000000000000000000000000000000000000000000000000000000000000000000000000000000
00000001000010000000000000000000000000000000000111111120000000000000201500010000000000000000000010001000100010001000100000000000000000000000000000000000000
00000001000010020000000000000000000000000000000000000002000000000000001000100000000000000000000000200020002000200020000000000000000000000000000000000000000
00000001000000000000000000000000000000000000000000000020000000000000021001000000000000000000000000000000000000000000000000000000000000000000000000000000000
00000001000000020000000000000000000000000000000000000002000000000000001010000000000000000000001111111111111111111111110000000000000000000000000000000000000
00000001000000000000000000000000000000000000000000000020006060010060061100000000000000000000000000000000000000000000000000000000000000000000000000000000000
00000001111111110000000000000000000000000000000000000002111111111111111000000000000000000000000000000000000000000000000000000000000000000000000000000000000
